R    3476   6786
NO ./path_to_the_north_texture
SO ./path_to_the_south_texture
WE ./path_to_the_west_texture
EA ./path_to_the_east_texture

S ./path_to the_sprite_texture
F 220,100,8
C 225,30,0
      1111111111111111111111111111111111111111111111
      1000000000110000000000001
11111111100000000000111111111111
100100000000000000000000111111111
           111111111011000001110000000000001
100000000011000001110111111111111
                   11110111111111011100000010001
11110111111111011101010010001
11000000110101011100000010001
10001000000000001100000010001
1000000000000000110101001W0001
110000011101010111110111100111
11110111 1110101 101111010001
11111111 1111111 111111111111