R 1000 1000
NO ./textures/colorstone.xpm
SO ./textures/mossy.xpm
WE ./textures/eagle.xpm
EA ./textures/alpha.xpm

S ./textures/barrel.xpm
F 220,100,8
C 225,30,0


        1111111111111111111111111
        1000000001100000000000001
        1S00000001110000000000001
111111111000000000000000000000001
111000222222220000000000010000101
100000000000000001110100001011111
11110000000000000000100000011
11111111111111111101111111111
11111111111111111111111111111
11110000000001111110000000111
11000000110101000000000010001
10000000000000001100000010001
10000000000000001101010010001
1100000111010101111101111000111
11110111 1110101 101111010001
11111111 1111111 111111111111