R 1000 1000
NO ./textures/colorstone.xpm
SO ./textures/colorstone.xpm
WE ./textures/colorstone.xpm
EA ./textures/colorstone.xpm

S ./path_tothe_sprite_texture
F 220,100,8
C 225,30,0


11111111111111111111
10000000000000000001
10000000000000000001
10001010101010101001
10000000000000000001
10000000000000001001
10000000000000001001
10000000000000001001
100000N0000001111001
10000000000000000001
10000000000000000001
10000000000000000001
11111111111111111111